<sos>그리고 부터의 포스 유튜브 육하겠대<sos>	그리고 책상에 빼곡하게 붙어 있는 포스트잇들은 데이터로 만들어서 저장해
<sos>요즘 세가 잤어<sos>	음식 사진에서 생생한 근접샷은 필수거든
<sos>저렇게 보라들이 정지는 경우 주말이 정혀도 정말 바이는 경우이 주ㅁ<sos>	반려식물은 공기 정화 효과도 주지만 ,습기를 빨아들이는 효과도 있거든
<sos>정성 삼십 준대<sos>	찬물을 묻혀서 식초나 중성 세제로 씻어주면 돼
<sos>그게 잠식이야<sos>	그리고 잠들기 두 시간 전부터는 금식이야
<sos>벌인다고<sos>	버린다고
<sos>그런데<sos>	그럼, 스프를 먼저 넣을게
<sos>왜<sos>	왜 그럴까
<sos>그러니 오늘 부분이 있어요<sos>	그렇다고 부모님 용돈을 안 드릴 수도 없고 고민이에요
<sos>물어주에서 나이기 정도 경울을 물어줄 물어줄 정도로 정도로 지<sos>	누가, 왜, 무엇을 나에게 물어볼 지 경우의 수를 미리 적어놓는 거지
<sos>어떻게 해요<sos>	여보세요 어디시죠
<sos>당장 발시를 좋은 거 같아<sos>	당장 거실에 있는 쇼파도 가죽이고, 자동차의 시트도 가죽이잖아
<sos>정하면 가지겠어<sos>	썬크림을 이용하면 가죽에 광택도 낼 수 있어
<sos>사연두 알 수<sos>	살 물건들은 적어 왔어
<sos>다른 여러 주겠지<sos>	당연히 여러 개를 사면 할인해 주겠지
<sos>안 나는 교실 교장은 전에 부분 경유한 중에 부출과 상황에 부터<sos>	아침 시간엔 전날의 부부싸움, 출근길 교통 상황 때문에 부장의 심기가 상했는 경우가 많아
<sos>그러니까 아리 생기는 게 힘인기는 거 아냐<sos>	그러니까 아는 게 힘이라는 말이 생긴 거 아니냐
<sos>그러니까 면연이 좋은 좀 안 들어 나는 좋은 좋<sos>	그럼, 꼬들한 면이 좋으면 스프 먼저, 푹 익은 라면이 좋으면 면을 먼저 넣으면 돼
<sos>뭔데<sos>	뭔데
<sos>그래서 아침 부분이 중에 상품을 했어요<sos>	그래서 아침밥은 포기하고 삼십 분 일찍 출근하기로 했어요
<sos>애그러지 어<sos>	에이 그런 게 어딨어
<sos>그런 보디셔<sos>	그런 방법이 있어
<sos>혼자 같이 어세가 제칠 구셨다<sos>	혼자 하기 어색하면 친구랑 같이 해도 좋겠다
<sos>나는 별로 있네<sos>	난 요가는 별루인데, 다른 건 없어
<sos>어, 잠 시트<sos>	어우~ 요 며칠 날씨 참 좋다
<sos>그렇지<sos>	그 다음이 씨 캐롯이야
<sos>코로는 흥을 신도 그렇고 없정이잖아<sos>	코로나도 그렇고 어르신들은 건강이 제일 걱정이잖아
<sos>그마라르는 공종<sos>	그 말엔 나도 완전 공감
<sos>나 시간을 쌀 수 없어<sos>	날씨가 쌀쌀해져서 그런가
<sos>한 나트면 줄 줄 줄 줄 줄 줄 줄 줄 안 줄 ㄱ<sos>	하나 뜨면 줄줄줄 똑같은 것만 만들구
<sos>오~ 정발<sos>	오~ 전문가 같은데
<sos>그래도 다이도 아이다<sos>	그래도 오늘 날씨는 참 좋아 다행이다
<sos>역십 녀가 가고 하더라고<sos>	역사가 무려 칠십 년이나 됐다고 하더라고
<sos>심은 있어 기사 가자<sos>	신문에 기사가 나오고 했더라
<sos>그렇긴<sos>	그럼, 디저트는
<sos>와, 고소하겠다<sos>	와, 고소하고 담백하겠다
<sos>중은 알아<sos>	신문에 기사가 나오고 했더라
<sos>알러면 이야<sos>	어 그런 거 하는 컴퓨터 프로그램이야
<sos>요즘 사람들이 거기 가서 그렇게 가장 사람들이 ㅇ<sos>	뭐 그렇게 거창하게 가지 않아도, 요즘 사는 게 힘들어서 그런 영향도 있다고 하더라
<sos>어디서 코까가 코키서 나인지 효과가 있더라고 효과ㄱ<sos>	어디서 들었는데 코피가 날 때도 냉찜질이 효과가 있다더라
<sos>그리<sos>	불꽃놀이
<sos>그래서 나나 더 그거<sos>	그래서 난 별 걱정은 안하는데
<sos>그게 언니 되기도 하지<sos>	그게 수족 냉증의 원인이 되기도 하나
<sos>아무래도 우선 순계한 순식에서 좋은 순서도 정<sos>	아직 도착하지 않은 분들도 계시니 방명록상 오신 순서대로 소개해 드리겠습니다
<sos>근데 너는 것질 좋았지<sos>	근데, 너는 핸드폰으로 결제도 다 되게 해놓은 거지
<sos>그래도 하다고<sos>	그래도 자꾸 하다보면 늘어
<sos>그거 그거 좋아하자<sos>	그거 락스하고 물이랑 섞어서 뿌리면 효과가 좋아
<sos>요즘 때 일돼<sos>	일 대 일 대 일 뭐뭐뭐야
<sos>너 도대새 어디<sos>	너 도대체 어느 시대에 살고 있니
<sos>이때 홍태무 밤에 홍품을 하시는 거죠<sos>	육수 낼 땐 황태 머리나 북어 머리를 넣으면 더 시원한 맛이 난다
<sos>참사 미있어<sos>	참, 사람 사는 거 재미있어
<sos>순경이 오전 김자를 구운들이 구운적이 구운적이 구<sos>	그렇지 순간적인 충격으로 근육이나 관절에 손상이 온 경우에도 냉찜질
<sos>금색에 아무 많은 백 중도라<sos>	이상하게 조금 밖에 안먹었는데도 금새 배가 부르더라
<sos>없으지<sos>	없으면 패스
<sos>응 비트가 피트<sos>	응, 비트가 그렇게 좋다잖아
<sos>나무스러<sos>	라면은 너무 부담스러운데
<sos>저건<sos>	저건 쉬워
<sos>그런데 아르크럽 하얀 다른 사람들이 있었어<sos>	그런데 내가 아는 사람은 고양이를 입양했다가 곧바로 파양한 경우도 있었어
<sos>든제 드라가가 우기 진짜 들어간 들어가지기 알지야<sos>	된장찌개에 들어간 고기 약간, 멸치, 김치에 들어간 새우젓 등 빼면 다 채식이야
<sos>그래서<sos>	그래서
<sos>아, 오늘은 하지<sos>	맞아 온라인 쇼핑을 하면 그런 걱정은 없지
<sos>으때 보트라<sos>	호텔보다 훨씬 저렴하잖아
<sos>뭐 크럼 재<sos>	먹고 사는 문제에 쿨한 게 있어
<sos>그러니까 그런데 어쩜은 영화가 그런 영화가 그런 영화가<sos>	그런데 그런 영화보다는 <테넷> 같은 영화가 어쩌면 더 나을 수 있겠더라고
<sos>나자<sos>	남자 여자
<sos>한국이 동생은 한국이 동시를 정제 안 지를 많<sos>	그러고 보면 한국인이 동물성 단백질을 많이 먹은지 얼마 안되지 않았어
<sos>내용은 이유 있잖아<sos>	내용은 이해가 잘 되지만 재미없는 영화 있잖아
<sos>밤에 비르가 중에 바다는 걸 받아서 아니고 아니를 <sos>	나도 아침에 필요한 재료가 떨어진 걸 밤에 알아서 곤란한 적이 꽤 많았는데
<sos>그래도 그 인화 그 인말 주업이 주고 그랬다<sos>	그건 그래 네 말 듣고 보니 신선 식품 쇼핑은 좀 자제해야 될 것 같다
<sos>정에도 가족정을 경우에 가족장 아저 마음에 가족<sos>	다들 그렇게 걱정해도 어떻게 어떻게 꾸려가 너무 걱정 마
<sos>완전 게 사일 것이 가<sos>	완전 사이코패스 같아
<sos>벌진 돈이지 않아<sos>	보면 알아 버려진 동물인지
<sos>자대라도 하네<sos>	다 내가 좋아하는 음식들이네
<sos>왜 있어야 돼<sos>	왜 무슨 말이 있었길래
<sos>만자<sos>	완전 사이코패스 같아
<sos>그걸<sos>	컴퓨터 활용 능력
<sos>그게 좀 문제<sos>	그게 좀 문제긴 한데
<sos>과과가 버려야 생겨 잘 바로 잘 바로 좋이 이래<sos>	과거 세대가 파괴한 자연 생태계를 바로 잡기 위해 미래 세대에서 오지
<sos>요즘 유튜브 하나<sos>	요즘은 유투브 안하면 안 되나 봐
<sos>그니까 저렇게 되게 되게 되게 해야 되겠다 그런 ㄱ<sos>	그니까 전혀 다른 관점으로 애들을 애들은 톡톡 얘기하거든
<sos>뭐 약필은 그 전에 그겠잖아<sos>	뭐 재료가 있던데 피클 그거 약간 새콤한 맛 나게 하는거 있잖아
<sos>저 중요하기 많은데<sos>	솔직히 먹는것도 중요하지 중요하기는 한데
<sos>얼마는 게 골라서 차이어도 그렇게 하고<sos>	얼른 사지고 자꾸 또 챙겨서 먹어 지고 그런
<sos>다 나는 생기었어<sos>	발란스가 깨져 가면서 뭐가 약해지니까
<sos>그렇게 해도 가죠<sos>	그렇게 해야 될 것 같애요 아프지 말아야죠
<sos>뭐 그 뭐 그는 게 있는 거 뭐 그랬어<sos>	혹시 본 영화 중에서 뭐 기억 남는 거 뭐 혹시 있나요
<sos>이제 감자 감자 이제 가<sos>	요즘 또 감자 이런 게 너무 싸더라
<sos>집 물을 다 보면서 무스지만 사람들이 집지 말이 다 ㅂ<sos>	집집마다 보면은 한 사람씩 다 무릎 수술한 사람들이
<sos>그러니까 그러게 들어가지 들어가지<sos>	그러니까 이제 우리가 흑백논리에 들어 가게 되는거지
<sos>그래 그러고 그러고 담은 밤은 그렇겠더라고요<sos>	그래 금요일 날은 신랑도 밥 먹고 들어오거든
<sos>나는 밥이 그러고 나왔어<sos>	밥이 그날 안 들어갔어 나는 밥을 안 먹어서 내 몸에
<sos>그 당난 고일 수 없지 않고<sos>	그 다음에 오이를 썰어 갖고 설탕물 짜고
<sos>정물이 하는 거 사<sos>	너무 멋쟁이야 저기 며느리하고 사는데도
<sos>그렇게 제일 좋아<sos>	그 체중 줄이기가 그렇게 이렇게 힘이 들어요
<sos>이제 뭐 컴퓨터가 그런 거<sos>	이제 뭐 엄마가 사전에 컴퓨터로 조금 검색해서 가면
<sos>좋은 유명하게 동기 그 동기가 거기 그 동기가 유명<sos>	좀 유명한 집들이 많더라구요 거기 그래서 그 동네가 유명해요
<sos>오줌에 가시고 그러는데 그러는데 그러는데<sos>	오기만 하면은 외식하자고 그러는데 내가 싫어해요
<sos>야 가서 그렇게 해 보고 이렇게 했었어<sos>	예약해 놨다고 휴가 때가서 검사해 볼 거라고 이야기를 했었어
<sos>보험 시에 안 되어 안 되고 그걸 없었었었었었어<sos>	보고 왔는데 우리 애 아빠는 건강을 엄청 신경쓰다보면
<sos>나도 저 정보 적지 예약했어요<sos>	나도 적지 않은 나이에 지금까지 성인병에 대해 공부하고 있어요
<sos>그러니까 참 대해 그게 참 마있지<sos>	병이라는 게 창대해지겠지 그러니까 참 아휴 글쎄
<sos>그러냐 이 들어서 주를 하게 되는데<sos>	그냥 이 뇌출혈로 쓰러져서 그래서 시작이 된건데
<sos>저도 있더 이메 도사를 하려면 도사를 하나 도사를 하ㄴ<sos>	저도 이제 마흔 두 살에 뒤 늦게 늦둥이를 하나 또 더 봤어요
<sos>이렇게 사는 이렇게 삼책을 도워서<sos>	이렇게 해서 산행을 다니면서 체력도 길렀고
<sos>이런 쇼프 토프 계좌 많더라구<sos>	이런식으로 고추장만 넣으면 그게 좀 텁텁해요
<sos>어르지나 생선이나 생선이 좋아하고 있지 않았<sos>	워낙 좋아하진 않다 보니까 생선이나 해물류 저기 채소
<sos>그러니까 편이 더 필요만 했어<sos>	그런 게 더 많으니까 돌아 다니는 더 편했어
<sos>부동사라 가지 뭐<sos>	부동산 있는 사람이 다 가지고 있지 뭐
<sos>애들 라고<sos>	뺐다고 하더라고
<sos>한 구술리는 구슬 하는데<sos>	갔다 오긴 했는데 또 가고 싶어 한 구슬는
<sos>보통이 생일 사십도 오래 놓으려고 자십도 자십<sos>	보통이 사십 도 겨울에는 사십오 도 된다고 하더라
<sos>그리게 작자 있어요<sos>	근데 찹쌀을 네 시간 이상 불려 놔야 돼요
<sos>가끔 좋았어<sos>	가격도 괜찮고 맛도 괜찮았어
<sos>다른 게 이제 이제 이제 몰 정보 이제 하지 않을까<sos>	다른 방법을 찾아보는 거 그냥 인생을 즐기는 게 더 낫지 않을까
<sos>그리고 눈이 애완 처음 뻑뻑해서 경원이 어떨게요<sos>	그리고 눈이 뻑뻑해서 병원을 갔더니 노안 초기예요
<sos>그 가족 다시 보면은 다 좋더라고<sos>	식당 보통 보면은 그 가족들도 다 식당을 하더라고
<sos>아꾸 이렇게 아꾸 있어서 있어<sos>	애들이 어려서 아직 계획만 하고 있고 못 가고 있어
<sos>근데 보미이라고 하는 보미에서 보미이라고 하는 게 전에서<sos>	근데 그거는 보미에서 보미 해상이라고 이렇게 전화로 하는 게 있더라고요
<sos>말이 좋을 것 같이 돼서<sos>	많은 추억을 가지고 오게 돼서 너무 감사했고요
<sos>제 코미 재미있게 코믹 나왔어<sos>	뭐 이렇게 재미나 뭐 이렇게 코믹한 건 없었어
<sos>그 이유를 하고 이어떤 사람들 지잖아<sos>	사실 그때 나왔던 사람하고 또 이 영화 제작했던 그 인물들 그 가수들하곤 또 틀리잖아
<sos>지금 그렇겠니까<sos>	제목을 그렇게 한 건가
<sos>너무 좋은 주였어<sos>	너무너무 좋은 여행이었고 너무 추억이 많은 여행이어서 너무 좋았어요
<sos>그건 좋은 지일 안 좋을 했지<sos>	그거 하고는 좀 이제 나온 노래한 사람들이 틀려서 그런지
<sos>영화를 말을 장소하는 것은 장소해서 영화를 장소해서 영화를 장소해서<sos>	여행사 같은 데서 테마별로 이제 뭐 명화를 찾아서 아니면은 어떤 장소 영화를 많이 찍은 그런 거
<sos>할 때 초금 했더니면<sos>	계 모임을 하자 해서 초급만 때부터 해서 한 십칠 년 했거든
<sos>너는 어른 얼룩해 주고 하겠어<sos>	너는 국내는 어디 애들 데꾸 놀러 가 볼 만한 생각해 본 데가 있어
<sos>이제 뭐 말 고<sos>	이제 우리 뭐 매일 빨가 벗고 만나 가지고
<sos>아무 사실 여기 좋겠고<sos>	합류가 안 되고 사실 여기는 참 시설이 좋거든
<sos>네트<sos>	내릴 때 힘드니까
<sos>자기가 그 생각자 그 중에 가장 가장 가고 주도 좀 가자 그 지아 가장<sos>	장기간 가 있는 것보다는 짧게 만끽하고 오는 게 가장 좋지 않을까 그 생각 들더라고
<sos>에스이 우유 크루즈<sos>	네 그렇군요 맞아요 에스유뷰는 경유죠
<sos>우리 모임 자는 게 아는 게 아나<sos>	그런데 우리는 모임 열두 명 하는 모임 있잖아
<sos>그러디 골드고 이렇게 다 이유 다이었잖아<sos>	그 좁은 골목을 차도 다니고 오토바이도 다니고 사람도 다녀
<sos>그것마다 있네<sos>	그리고 지역마다 그 특산품이 나와 있는데
<sos>대인을 정리했어요<sos>	됐는지 한 삼 개월 전에 이 건강 검진을 했어요
<sos>그리고 안 제일 서 왔는지 못 거야<sos>	덥지도 않고 춥지도 않고 그리고 인제 배에서 여행하면서
<sos>마음 그래서 많은 것도 먹고 있었고<sos>	그래서 나는 거기서 이제 베트남 차도 먹고 싶었고 막 그랬거든
<sos>녹스를 집스를 된대 이겠다 봐<sos>	놓고서 거기에다가 이제 육수를 내야지 닭 육수를 내야 되는데
<sos>그건 여리하면 하자 그러자고<sos>	둘이 한 번 나가 보자고 가을에 안 되면 내년에라도 한 번 열심히 연습을 하자
<sos>그래서 그것도 자주 이제 보니까<sos>	그래서 그것 때문에 이제 먹거리 유독 관심 갖고 건강식품을 찾다 보니까
<sos>그게 우른 지 있어<sos>	그게 돌아왔는지는 모르겠어
<sos>순밀 언네 몸이 아빠 내가 내가 내가 숨 결국에 하도 지겼대<sos>	내 몸이 숙면을 못 취하게 내가 혹사를 시켰던 거야
<sos>주스는 안 좋아요<sos>	인라인 스케이트는 안전한 곳에서만 타요
<sos>이런 시간 봤어<sos>	너 오늘 방과후 수업 있어
<sos>발레이스트에서 도이스에서 새일 생일 생일 거야<sos>	토요일에 내 생일이라서 생일 파티를 할 거야
<sos>그러니까 말해<sos>	그러니까 너도 엄마한테 말해
<sos>왜 때려<sos>	왜 때려
<sos>아빠랑 없어<sos>	아빠랑 엄마랑 어떻게 만났어
<sos>저기 좀 하고 해 보이니다<sos>	저기 쪼그랗게 하얀 거 보인다
<sos>알이 디지 알아<sos>	에이비씨디도 알아
<sos>노그 할 때 줘<sos>	목성은 예쁜 띠를 두르고 있어요
<sos>골이 잘 하는 거지 지주지지 않아<sos>	콩나물이 자라면 하늘까지 닿을지도 몰라
<sos>응 또 만든 거는 줄거지야<sos>	난 똥이고 너는 똥파리고 쟤는 휴지야
<sos>엄마가 새가 새고 안 말하고 새가 새가 새<sos>	엄마가 새 운동화랑 새 옷을 사오셨어요
<sos>디딩크레그는 나보다 어린 좋아요<sos>	핑크색은 나보다 어린 동생들이 좋아해요
<sos>니 거 어떻게 했네<sos>	니 가방 어떻게 생겼는데
<sos>나는 인제 있대<sos>	나는 인절미가 좋은데
<sos>저번 거 아니야<sos>	여기 접어야 하는 거 아니야
<sos>차가 그러는 풀게<sos>	차가 엄청 막힌다
<sos>나도 모르겠을 뛰어도 머리 하러 머리<sos>	나도 백설공주처럼 머리띠 할래
<sos>너도 몰랐는데 하나 만들래요<sos>	나도 먹을래 하나만 주세요
<sos>마스크 어지<sos>	마스크 어디 있어
<sos>아까 아빠 아파<sos>	움직이면 아파 엉덩이 아파
<sos>나 콩으로 나 고그러질 줄 알아<sos>	나 콩나물도 먹을 줄 알아
<sos>나는 소주실 선볼 거야<sos>	나는 김치 씻어서 먹어
<sos>그럼 와신 거야<sos>	그럼 맛있는 거 먹으러 갈거야
<sos>신밖에 발파요<sos>	신비아파트 보고 싶어요
<sos>치즈 하니까 손이야<sos>	채송화니까 송화야
<sos>아는 고<sos>	공원에서 솜사탕 파는 거 봤어
<sos>양치지를 했어<sos>	양치질 했어요
<sos>비씨라<sos>	병원 가기 싫어
<sos>그버 보랐어<sos>	눈이 다 녹아버렸어
<sos>비하는 생일 몇 시에요<sos>	피아노 선생님 몇 시에 와
<sos>선물은 잠에 잠은 잠에 잠을 잠을<sos>	삼촌이 취업만 하면 장난감 다 사준대
<sos>누가 때라 쓰거 냈어<sos>	누가 내 칭찬 스티커 떼 갔어
<sos>비가 안 놀 수 있는데<sos>	비가 안 오면 밖에 나가서 놀 수 있는데
<sos>삼촌은 다 만들 가면 다 좀 다 줄 거야 돼<sos>	삼촌이 취업만 하면 장난감 다 사준대
<sos>바장은 차 풍을 수 있고<sos>	바다탐험대 옥토넛에서 상어 나왔었는데
<sos>엄마 실으면 안 돼<sos>	엄마가 열두시에 만나자고 그랬는데
<sos>대체 아주 알이야<sos>	진짜 되게 재밌어요
<sos>너 있어 있어<sos>	나는 이모 없는데 삼촌 있어
<sos>집은 것이 부럽도 잘 도웃이 받아<sos>	티비도 자기가 보고 싶은 것만 봐
<sos>준서는 아빠는 사려줄게<sos>	준서네 아빠는 망원경 사줬대
<sos>그럼 혼나서 끌어 봤어<sos>	우리가 시끄럽게 해서 혼났어
<sos>감비 오면 안돼<sos>	감기 옮으면 안돼
<sos>같이 도왔자<sos>	같이 기도하고 자자
<sos>다시 보자<sos>	다시 해 보자
<sos>리구지야<sos>	응 미국인이야
<sos>근데 거기 거기 거기 가서 사질 거 같애<sos>	근데 거기 가서 사진만 찍어오면 돼
<sos>오물 줌 줄 있어서 선물 줄 있어<sos>	우리가 널 위해서 선물도 준비했어
<sos>이제 우리 가이다 이제 다 있겠다<sos>	다행이다 이제 우리 같이 놀 수 있겠다
<sos>나는 들어<sos>	나는 별명 없는데
<sos>이부티 하니 너무 좋다<sos>	이 물티슈 향이 너무 좋다
<sos>이 좀 좀 좀 좀 좀 좋은다<sos>	이 감자 칩은 좀 짠 것 같아
<sos>내 물은 사람이 물 물에 볼 때문에 버키우<sos>	매스컴 때문에 피해 보는 사람이 생기면 어떡하나
<sos>그럴 잘 했을 때 학교하는 잘 했어서 하게<sos>	그 학생은 에세이를 잘 써서 합격했다는데
<sos>저는 활동하기 불자일 또 하도 드리고 하기<sos>	짧은 스커트는 활동하기 불편할 거 같아
<sos>그럼 이렇게 해놓을러야 해<sos>	그럼 이다음에는 어떤 아이콘을 눌러야 해
<sos>논 아이어브 유어<sos>	너 연예인한테 사인받아본 적 있어
<sos>슈크<sos>	실크
<sos>정다비러 생각하는 보겠어요<sos>	정답이라고 생각하는 보기에 체크하세요
<sos>나는 몰라세야 밖에 아빠가 빠빠가 빠빠가<sos>	요새 아파트 매매가가 너무 올라서 난 집 못 사
<sos>스트레<sos>	스크린
<sos>룬<sos>	르네상스
<sos>다 매로 먹을 거<sos>	밤에 라면 먹으면 다음 날 얼굴이 부어
<sos>월드커<sos>	월드컵
<sos>사버도 주주스 좋아해<sos>	사과주스랑 포도주스 중에 뭘 좋아해
<sos>어떻게 플럽에 가요<sos>	이 클럽에 가입하려면 어떻게 해야 하지요
<sos>하이퍼를 그렇게 그렇지 선물을 볼 수 있으면 천<sos>	하이퍼링크를 클릭하면 참고자료를 볼 수 있습니다
<sos>어제 사람들은 아우지 않아서<sos>	어제 산 보일러가 고장 나서 온수가 나오지 않아요
<sos>벡션<sos>	액션
<sos>링비<sos>	인터뷰
<sos>룰<sos>	물티슈
<sos>이번에 톨리가 사 봤어<sos>	이번에 이쪽에 터널 뚫려서 더 빨리 갈 수 있어
<sos>내가 어릴 때 학원 했대 가지만 했었는데<sos>	내가 어릴 때까지만 해도 아날로그 시대에 살았었는데
<sos>호텔 부러주는 한데 부러주세야<sos>	호텔 앞으로 리무진 한 대 불러주세요
<sos>나블리스는 어블레이셨어<sos>	러블리즈 노래 들어본 적 있어
<sos>밤이 디프 적이 뭐야<sos>	판빙빙 대표작이 뭐야
<sos>홈<sos>	홍콩
<sos>스타마는 매주가 몇 시더라는 ㄱ<sos>	스타만 하면 몇 시간은 금방 가요
<sos>델<sos>	델
<sos>제가 제일 좋아하는 노래 놓아<sos>	제가 제일 좋아하는 노래는 하바나예요
<sos>어느 나라 기업스는 미아라 기어<sos>	필립스는 어느 나라 기업이야
<sos>오전하는 혼자 서 공부리 수 있겠어<sos>	오전 안에 혼자서 다 공구리 칠 수 있겠어
<sos>제가 그게 제일 좋은 게 좋으러 가요<sos>	전 다크 나이트가 그렇게 재미있는지 모르겠어요
<sos>요즘 치앙미아 마세스 속수는 순적으로 보<sos>	요즘 치아문단순적소미호 보는 맛에 살아
<sos>도이아온 있지<sos>	보헤미안 랩소디가 언제 개봉했지
<sos>드유브 개통이라 기업 들야<sos>	그 미국 대통령이랑 관련된 게이트가 뭐더라
<sos>다크<sos>	다크서클
<sos>프치노<sos>	프라푸치노
<sos>이번 해 줘<sos>	이번에 나온 애드 시런 노래 너무 좋아
<sos>그래도 등<sos>	맥도날드
<sos>저 또 상에 계획 개국 시으로 상의<sos>	대학생 취업 선호도 상위권에 케이티앤지는 꼭 있더라
<sos>에너제트<sos>	에너제틱 틀어줘
<sos>난 이거 완전비 나겠다<sos>	나 이거 완전 빛이 나게 그라인딩 했다
<sos>조크루스폴 걸<sos>	작년에 마이크로소프트 주식 좀 사둘걸
<sos>코텔<sos>	호텔
<sos>야<sos>	에어팟
<sos>왔자<sos>	왓챠
<sos>저무선 음으로 바꾸 잘 서 용구 잘했어<sos><sos>	저 선수는 너무 잘해서 도핑 의혹을 받고 있어
<sos>이번에 아리아 그래<sos>	이번에 아리아나 그란데가 내한한대
<sos>저건 출국이 저화 하실 거야<sos>	저와 함께 출근길 카풀 하실 분을 구합니다
<sos>물고스를 커퍼스를 구야<sos>	문구사에 가면 컴퍼스를 쉽게 구할 수 있을 거야
<sos>라운드 몸피스 먹으려는 결환주 결혼ㄷ<sos>	라운드 넥 원피스에 진주 목걸이를 하고 결혼식에 갔다
<sos>프라스에 갈 먹어봐<sos>	프랑스에 가게 되면 꼭 카나페를 먹어봐
<sos>꽃는 거 공양이 위해 가도 좋을 수 있다<sos>	코너킥을 성공하기 위해 공의 각도를 조절했다
<sos>오늘방에서 해 받아야지<sos>	오늘 밤 마당에서의 칵테일파티 잊지 않았지
<sos>저 부라는 부부 좋겠지 저렇게 좋지 있지 않아<sos>	게임 팩 꽂는 부분의 접지가 불안해서 자꾸 게임이 꺼진다
<sos>나 콜러리게 전화이 하나<sos>	나에게 전화 걸어서 컬러링 한번 들어볼래
<sos>내 타일을 할 수 있는 것봐<sos>	넥타이를 하지 않으니 여름에 훨씬 덜 덥다
<sos>와, 숍 하는 게 부소가 였다<sos>	마약사범들의 커넥션을 발견하여 구속하였다
<sos>누기자<sos>	북 디자인
<sos>구가에 내가 있을 거 가야<sos>	구겐하임미술관에 한국어 오디오 가이드가 있다
<sos>저 글릴 수 있는 거 바다는 일이다<sos>	글씨를 드래그하면 블록 처리가 됩니다
<sos>저 인화인을 이스터는 두 모임 수천이 아이었<sos>	저기 붙어 있는 노 스모킹 사인이 안 보이세요
