<sos>우리는 익숙하지 마야<sos>	우리라도 솔직히 말씀드려야 되는 거 아니야
<sos>제가 며칠 동안 인터넷을 뒤져서 알아<sos>	제가 며칠동안 인터넷을 뒤져서 알아낸 방법이거든요
<sos>하루 반이 지났기 때문에 굳이 트야<sos>	하루의 반이 지났기 때문에 굳이 트집을 잡아 수정시키기 애매한 시간
<sos>차라리 갑질이면 공론화라도 할텐데<sos>	차라리 갑질이면 공론화라도 할텐데 그게 참 애매해
<sos>노멀<sos>	놀아주면 좀 나아져
<sos>자면서<sos>	자면서 다이어트
<sos>실제로 블루 먼데이라고 해서 월요일에 자살하는 사람이 제일 많대<sos>	실제로 블루 먼데이라고 해서 월요일에 자살하는 사람이 제일 많대
<sos>어떻게 그렇<sos>	어떻게 그런 걸 다 알았대
<sos>네가 한 번 해 보자<sos>	네가 한 음식보다는 라면이 낫겠구나
<sos>관상용으로 공중에 걸어서 많이 키우는데<sos>	관상용으로 공중에 걸어서 많이 키우는데, 화장실에서 키우면 특히 좋아
<sos>그땐 서글<sos>	그 생각까지는 못했어요
<sos>그래서 직진 음식을 섭취하거든 근데 얼마나 노력을 샀대요<sos>	저는 요즘 집에서 도시락을 싸오는 데 그것도 은근 절약이 되더라구요
<sos>그런 일을 맡은 건가<sos>	그럼 팀장님께 업무 일지를 공유하는 걸 말씀드릴까
<sos>아무래도 그렇지<sos>	아무래도 그렇지
<sos>그런 기능<sos>	그런 기능이 있어
<sos>집에서 밥을 해먹자<sos>	집에서 밥을 해먹기 시작해야 진짜 자취야
<sos>그래서 필름 사진을 꾸준히 찍는 강사랑 사십오 일간 사진을 매일 찍고 공유한대<sos>	그래서 필름 사진을 꾸준히 찍는 강사랑 사십오 일간 사진을 매일 찍고 공유한대
<sos>머리<sos>	머리도 아프던데
<sos>그건 쉽지 않네<sos>	그건 쉽지 않네요
<sos>그럼 됐지<sos>	그런 것들 먼저 치우면 되지 않을까
<sos>앞으로는 몇 번에 한 번이라도 해 내 개봉해야겠어<sos>	앞으로는 몇 번에 한 번이라도 내가 내겠다고 해야겠어
<sos>영양제도 안 먹은지 육 개월이 지났어요<sos>	영양제도 안 먹은지 육 개월이 지났고, 책도 일 년 넘게 펴보지도 않았어요
<sos>접시가 테이블 위에서 약간 사는 거지<sos>	접시가 테이블 위에서 약간 사선이 되게 찍으라는 거지
<sos>네 분명 축하해야 할 일인데 제 통장 사정을 생각하면 웃음이 안 나네요<sos>	네 분명 축하해야 할 일인데 제 통장 사정을 생각하면 웃음이 안 나네요
<sos>하긴 빈대떡은 대표적인 서민 음식이니까<sos>	하긴 빈대떡은 대표적인 서민 음식이니까
<sos>무슨 과일<sos>	무슨 과일 사려고
<sos>오<sos>	오, 어디
<sos>다음부턴<sos>	다음부턴 그러지 말아야겠다
<sos>응 그런 다음<sos>	응 그런 다음 자기공감행동을 하래
<sos>그러니까<sos>	그러니까
<sos>네 말 들으니까 나도 꼭 한 번 가보고 싶네<sos>	네 말 들으니까 나도 꼭 한 번 가보고 싶네
<sos>크게<sos>	그게 다야
<sos>쑥스러워하실 줄 알았는데 의외로 엄청 좋아하시더라고<sos>	쑥스러워하실 줄 알았는데 의외로 엄청 좋아하시더라고
<sos>그냥 똑같네<sos>	근데 뭘 어떻게 해야 돼
<sos>그렇겠다<sos>	그렇겠다
<sos>어린이집 알림장에<sos>	어린이집 알림장에
<sos>나이도 잘 챙겨도 되고<sos>	아이들도 재밌게 잘 갖고 놀고
<sos>뭔데<sos>	뭔데
<sos>글쎄, 깊이 생각해본 적은 없는데<sos>	글쎄, 깊이 생각해본 적은 없는데
<sos>시골에서 오일에 한 번씩 서는 그 시장 말이지<sos>	시골에서 오일에 한 번씩 서는 그 시장 말이지
<sos>그렇지<sos>	그렇지
<sos>근데 버튼 두 번만 누르면 결제가 끝나니까<sos>	근데 버튼 두 번만 누르면 결제가 끝나니까 겁이 나긴 하더라
<sos>이번 코로나 때문에 결혼식 문화는 확 바뀔 거 같아<sos>	이번 코로나 때문에 결혼식 문화는 확 바뀔 거 같아
<sos>얼어붙은 흙이 녹으면서 안돼<sos>	얼어붙은 흙이 녹으면서 안에 매장된 메탄이 폭발하듯 나오는 거래
<sos>손님들 주문하는 거 같아<sos>	손님들 초대하려면 마당도 넓어야겠다
<sos>이따 건배사 당자켓은 직결국 하거든<sos>	일단 당근마켓은 직거래를 권장하거든
<sos>응<sos>	응 받았지
<sos>감기 화자<sos>	갑자기 화가 난다
<sos>대신 착<sos>	괜찮을 것 같은데 실용적이고
<sos>어째서<sos>	어째서
<sos>넌 찌찌찌찌찌찌찌찌찌찌찌찌찌찌찌찌찌찌찌찌<sos>	너 엔번방 디지털 교도소 봤어
<sos>알지 조금 할 수 있는데<sos>	알겠어 알겠는데, 좀 대중적으로 입맛이 변해가잖아
<sos>아주 먹을 줄 알지<sos>	아주 먹을 줄만 알지 몸 움직일 줄 모르는 사람들이야
<sos>또 뭐 해줄게<sos>	또 뭐 하면 어떻게 하지 뭐 이렇게 해 가지고
<sos>맞다 디엠이<sos>	맞아 요즘 허영만의 백반기행 그거 재밌더라
<sos>오대 영양소가 많이 안 받아 주지 않고 먹는 방법도 있어요<sos>	반찬이랑 골고루 오대 영양소가 빠지지 않게 먹는 방법도 있어요
<sos>오르는데 굳이 내가 한 일주일은 열심히 잡아 가시잖아<sos>	우리가 시작은 일로 시작을 했는데 가다 보면
<sos>이제 건강이 좀 신경을 써주는 편이야<sos>	예를 들어 경주에 가면 이제 신라시대 박물관 가잖아
<sos>나이도 잘 우리도 우리가 걱정이야<sos>	나이도 잘 잘 우리도 우리가 걱정이야
<sos>나는 앞에 우리 애 아빠는 데로 밥을 먹고<sos>	또 나 나름대로 고맙고 우리 애 아빠 보면은
<sos>시간 지나면 막 찐하게 변하고 또 짜지고<sos>	시간 지나면 막 찐하게 변하기도 하고 또 짜지고 하니까
<sos>오페라의 문제 할<sos>	어떻게 오빠한테 말을 했더라고요
<sos>천지차이더라 이거야<sos>	천지차이더라 이거야 차이가 너무 많이 나요
<sos>그런 생각이 들더라<sos>	응 그래야 그런 소리도 안 듣지 이런 생각 들어요
<sos>요즘 동화 작가들이 너무 교육적이래<sos>	요즘 동화 작가들이 너무 교육적으로 잘 적어 놨데
<sos>된장이라도 하나 보글 보글 끓여야 한다고 생각해<sos>	된장이라도 하나 보글 보글 끓여야 한다고 생각하기 때문에
<sos>너무 많이 생기는 거 같애<sos>	너무 많이 생기는 거 같애 홍보도 많이 하고
<sos>그렇게 지금 먹고 있어요<sos>	그렇게 지금 먹고 있어요 그리고 아침 식사에 신경쓰고 있죠
<sos>밖에 추럴 수도 없지<sos>	다른 분들 술을 그렇게 많이 잡수고
<sos>다이어트까지 좀 해 봐야 되겠다<sos>	다이어트까지 좀 해 봐야 되겠다 생각하고 있어요
<sos>근데 우리가 생각하는 게 아니잖아 그게 음식나 인자나 생각에 안<sos>	자연스럽게 나오는 게 아니잖아 근데 인제 우리가 생각해봐야하는게 있지
<sos>그 사람 궁금하다고<sos>	그 사람들은 더 부자가 되는거고
<sos>그래서 지금 몸에 담아<sos>	그래서 김치를 저는 봄에 담아먹고
<sos>거기에 맞아<sos>	그게 맞아 건강을 위해서 맞는 거 같애
<sos>한국 인정이<sos>	안 가 본 여행지가 별로 없는 것 같애
<sos>요즘에는 우리 애가 지금 무리가 봐<sos>	요즘에는 우리 애가 지금 중고등 학생이라
<sos>우리 그거 맡기 일 년<sos>	우리 그거 맡기면 일 년에 적금 하듯이
<sos>우리나라를<sos>	우리나라를 많이 선호 하면
<sos>사이즈도 이런 게 참 잘 되어야 되는데<sos>	사회보장 제도 이런게 잘 되어야 되는데 그치
<sos>요 녀석이 이런 건방진 행동 하더라도 내가 이해가 되더라고요<sos>	요 녀석이 이런 건방진 행동 하더라도 내가 이해가 되고 되더라고요
<sos>요가를 하는 게 더 밖에서<sos>	요가를 하는 게 더 밖에서 이렇게 움직이는 것보다 앉아서
<sos>이천 넘는데<sos>	이천만 원 이상을 안할거다 했는데
<sos>그렇게 큰 병이 와 가지고 한 달 되는데<sos>	그 날 그렇게 가지만 완전 코스피와 코스닥이 다 떨어지는데
<sos>그런데 요즘에는 만약에 내가 천만 원에 자기한테<sos>	그런데 요즘에는 만약에 내가 천만 원 자기한테 보내고 싶다면
<sos>그래서 안 혀도<sos>	그래서 그냥 저도 압력밥솥파는데
<sos>울 엄마가 깜박 잊어버리고 내한테 얘기를 안 했네 너무 미안한 거야 그 날<sos>	울 엄마가 깜박 잊어버리고 내한테 얘기를 안 했네 너무 미안한 거야 그 날
<sos>산책 하듯이 여기는 왓포 사원을 이렇게 둘러보면은 경치도 너무 좋고<sos>	산책 하듯이 여기는 왓포 사원을 이렇게 둘러보면은 경치도 너무 좋고
<sos>그런데 그 언제 할 수 있어<sos>	그런데 그 언니는 그렇게 하진 않았어
<sos>어 가면 엔 항상 괜찮을 것 같고 걔네도 괜찮을 것 같애<sos>	황리단길도 가면은 괜찮을 꺼 같고 첨성대
<sos>그런데 지더라고<sos>	그런데 옆에 언니가 귀뜸을 해 주더라고
<sos>우리가 생각하는 거 하고는 틀리서 만<sos>	우리가 생각하는 거 하고는 좀 틀리게 약간 이상한
<sos>그때 나이 먹어봤던 것들이 훨씬 기억이 많이 남고<sos>	그때 옛날에 봤던 것들이 훨씬 기억이 많이 남고
<sos>나 따뜻한 이제 진짜 잘 되게 생각하네<sos>	가까이 지내면 섭섭하게 생각할 수도 있을 거 같은데
<sos>치즈 맛<sos>	훨씬 더 멋있죠
<sos>자기네가 다 싶다던 그 자기 쁘기는 소득이 비렵다 싶다 그 생각이 들려서<sos>	자기는 다시 그 뒤편을 빌려서 또 봤다 그랬지
<sos>조크라우마<sos>	또 그런 사람은 또 줘야 돼
<sos>잠깐<sos>	잠깐 통화만 했거든
<sos>그거 얘기를 한 번 해 주고 사실 때<sos>	그게 그걸 얘가 예전에 홍콩 갔을 때도 시계를 하나 사온 게 있었거든
<sos>그때도 조금 얼마가 사겠구나<sos>	그때도 그분이 잘못했기 때문에 돈을 받아서
<sos>나도 그 영화 되게 재밌게 봤어<sos>	나도 그 영화 되게 재밌게 봤거든요 재미있고 너무 감동적이었어
<sos>들리고 나를 숙이 좀 사 먹는 게 낫대<sos>	되게 나도 모르게 나름에 상상의 소설을 쓰는 것 같애
<sos>나는 그거 진짜 크더라<sos>	나는 그렇지 않아도 그거 진짜 궁금하더라
<sos>완전 사고인데<sos>	완전 쫄딱 망해 가지고 거기 들어와서 그걸 하고 있는데
<sos>근데 내가 지금 생활비싸게 음 치 근데 내가 느낀 거야<sos>	근데 지금 현재 생활비 때문에 내가 신경이 쓰이는 거야
<sos>나는 여동생이 있어<sos>	나는 여동생이 있어
<sos>선배 위장에 야무<sos>	컴퓨터 게임 많이 하고 싶어요
<sos>제 생일이요<sos>	제 생일은 여름이에요
<sos>삼층에는 세 개나 다녀왔는데<sos>	한 층에 세 개씩 놓은데 그 위에는 반대 방향으로 세 개를 놓아
<sos>저희 엄마는 우리 학교에 다녀요<sos>	저희 엄마도 우리 학교 졸업생이에요
<sos>저희민이 아니면 친구는 생일이래요<sos>	저희 담임 선생님은 남자 선생님이에요
<sos>사학 때 운동장에 있는 건 고는 별 힘이 없다<sos>	살을 빼려면 굶는 것 보다 운동을 열심히 해야 해요
<sos>박쥐 같이 놀 수 있어요<sos>	학교에서 방학식을 했어요
<sos>나는 언니가 없어<sos>	나는 언니가 있고 동생은 없어
<sos>또 무슨 논<sos>	좀 무서운데
<sos>이거 봐 종이인데<sos>	이거 봐 종이인데 못 찢겠지
<sos>좋아 즐거웠구나<sos>	좋아 닭꼬치 안 매운 거
<sos>나는 수학 학원을 다니셨어요<sos>	나는 수학 학원을 다니기 싫어서 몰래 버렸어요
<sos>아 세상에서 제일 빠가 우리를 사야 된대<sos>	아 잘못 칠했어 빨간색으로 칠하려고 그랬는데
<sos>콩 들여줄<sos>	구명조끼도 입어야 돼
<sos>무너<sos>	눈이 따가워
<sos>할머니 뭐하지<sos>	할머니 나 화장실
<sos>기름이 뜨거워서 위험하대<sos>	기름이 뜨거워서 위험하대
<sos>재밌다<sos>	재밌다 또 다른 거 없어
<sos>도시락이랑 내 도시락이랑 바뀐 거 같애<sos>	니 도시락이랑 내 도시락이랑 바뀐 거 같아
<sos>그럼 우리 같이 볼까<sos>	그럼 우리 같이 먹자
<sos>이렇게 하는 거야, 어디 오는 거야<sos>	이렇게 하면 할아버지가 오는 거야
<sos>할머니 퇴사하고<sos>	할머니한테 해 달라고 하자
<sos>오징어<sos>	우린 친구니까
<sos>복주머니가 뭐야<sos>	복주머니가 뭐야
<sos>우리 오빠는 김치도 먹어<sos>	우리 오빠는 김치도 먹어
<sos>크리스마스가 좋아<sos>	크리스마스가 좋아
<sos>가만히 있어 봐<sos>	가만히 있어 봐
<sos>오늘 학원 안 가면 안돼요<sos>	오늘 학원 안 가면 안돼요
<sos>애기 봐요<sos>	레이디버그 볼 거예요
<sos>근데 토이 스토리가 손 데 없어<sos>	근데 토이 스토리 몇 편까지 나왔어
<sos>버섯을 넣어<sos>	버섯 싫어요
<sos>생각이 불러<sos>	생일축하 노래를 두 번 불러야 돼
<sos>약속<sos>	약속할 수 있어
<sos>콩에 넣자<sos>	구멍에 집이 있나 봐
<sos>그리고 나도 줄넘기 많이 할 거다 하루에 백번씩<sos>	그리고 나도 줄넘기 많이 할 거다 하루에 백번씩
<sos>니 거는 없냐<sos>	니 거는 저거야
<sos>우리 엄마는 샌드<sos>	우리 엄마는 머리 염색했는데
<sos>우리 엄마는 뚱뚱해<sos>	우리 엄마는 눈 뜨고 잔다
<sos>사람 충 있어<sos>	아빠랑 축구 게임 했는데 내가 이겼어
<sos>밤에 동생이 울어서 맨날 깨<sos>	밤에 동생이 울어서 맨날 깨
<sos>돌고 싶은 거 없어<sos>	경찰관 모자 쓰고 싶어
<sos>바다까지 헤엄쳐서 갈 수 있어<sos>	바다까지 헤엄쳐서 갈 수 있어
<sos>낚시 바늘에 먹이를 끼워 놓는데<sos>	낚시 바늘에 먹이를 끼워 놓거든
<sos>아쿠아리움에 가면 볼 수 있는데<sos>	아쿠아리움에 가면 볼 수 있는데
<sos>바퀴에 바람 빠진 거 같아<sos>	바퀴에 바람 빠진 거 같아
<sos>학교에서 샌드위치 만들기 했었어<sos>	학교에서 샌드위치 만들기 했었어
<sos>해가 질 수 있어<sos>	해가 질 때도 바닷속으로 들어가
<sos>엄마가 맨날 치킨시켜주면 좋겠어<sos>	엄마가 맨날 치킨시켜주면 좋겠어
<sos>밤에 별을<sos>	밥 먹는 것도 불편해
<sos>무슨 선택<sos>	누가 나 오줌 쌌대
<sos>아빠 그거 뭐 바르는 거야<sos>	아빠 그거 뭐 바르는 거야
<sos>우리 엄마는<sos>	우리 엄마는 척척박사야
<sos>이상한<sos>	이상한 냄새나
<sos>하나 더 먹으면 무음식이 떨어져<sos>	하나만 고르기 너무 어려워
<sos>우리 엄마랑 아빠랑 싸웠거든<sos>	우리 엄마랑 아빠랑 싸웠거든
<sos>신기하다<sos>	진짜 최고다
<sos>거기서 자꾸 추려<sos>	저기서 자꾸 틀려
<sos>준서가 장난쳐서 소율이가 다쳤어<sos>	준서가 장난쳐서 소율이가 다쳤어
<sos>너 가끔<sos>	나도 가끔 틀려
<sos>아직도 배가 콕콕 아파<sos>	아직도 배가 콕콕콕 아파
<sos>응 엄마가 아빠한테 존댓말 안 하면 혼나<sos>	응 엄마 아빠한테 존댓말 안 하면 혼나
<sos>니네 가 나 빼고 놀았잖아<sos>	니네가 나 빼고 놀았잖아
<sos>록달록<sos>	색깔이 알록달록해
<sos>지윤이가 깰지도 몰라<sos>	지윤이가 깰지도 몰라
<sos>애기는 알아<sos>	계이름 읽을 줄 알아
<sos>더 높이 힘들거 같은데<sos>	더 따뜻하게 해 줘야 할 것 같은데
<sos>채식하자<sos>	셋이 다 같이 나가자
<sos>정리하면서 바자회에 내놓을 물건 좀 찾자<sos>	정리하면서 바자회에 내놓을 물건 좀 찾자
<sos>마요네즈<sos>	마요네즈
<sos>나 사다시 태희망치라는 게티즈 김태스 만들어<sos>	난 샌드위치랑 주스 마실 거니까 사다 줘
<sos>그 집은 디지털 시스템의 수비법을 배워 보게 돼<sos>	그 집 시멘트 속에 보물이 묻혀있었대
<sos>오늘 아침에 일어나자마자 워드 작업을 시작했어<sos>	오늘 아침에 일어나자마자 워드 작업을 시작했어
<sos>여기 사람들은 다들 매너가 좋네<sos>	여기 사람들은 다들 매너가 좋네
<sos>나이트 갖고 있어<sos>	나 지금 카운터 아르바이트하고 있어
<sos>캠페인<sos>	캠페인
<sos>가스레인지<sos>	가스레인지
<sos>신발이 없어서 어쩔 수 없이 슬리퍼를 신고 나왔어<sos>	신발이 없어서 어쩔 수 없이 슬리퍼를 신고 나왔어
<sos>엘리베이터<sos>	엘리베이터
<sos>올해의 컬러는 클래식 블루라고 합니다<sos>	올해의 컬러는 클래식 블루라고 합니다
<sos>라면 끓일 때 면부터 넣어 스프부터 넣어<sos>	라면 끓일 때 면부터 넣어 스프부터 넣어
<sos>이번 월드컵에는 무슨 일이 있어도 참가하고 싶어<sos>	이번 월드컵에는 무슨 일이 있어도 참가하고 싶어
<sos>씨유<sos>	이슈
<sos>어버이날을 위한 예쁜 카네이션 사세요<sos>	어버이날을 위한 예쁜 카네이션 사세요
<sos>아까지만 해도 있었던 호텔 키가 없네<sos>	아까까지만 해도 있었던 호텔 키가 없네
<sos>나는 생크림 케이크는 느끼해서 싫더라<sos>	나는 생크림 케이크는 느끼해서 싫더라
<sos>트렁크<sos>	트렁크
<sos>생일선물로 팬티는 좀 그런가<sos>	생일선물로 팬티는 좀 그런가
<sos>멜로디는 떠오르는데 가사가 생각이 안 나네<sos>	멜로디는 떠오르는데 가사가 생각이 안 나네
<sos>오늘 저녁으로 가려면 골<sos>	오늘 저녁에 러시아 발레단 공연 보러 갈래
<sos>난 오늘 별로서 걱정이 못할 것 같아<sos>	남은 돈이 별로 없어서 백은 못 살 것 같아
<sos>카지노에서 도박하느니 차라리 기부하겠어<sos>	카지노에서 도박하느니 차라리 기부하겠어
<sos>한국 돈 오만 원을 달러로 바꿔 주세요<sos>	한국 돈 오만 원을 달러로 바꿔 주세요
<sos>이 책은 천 페이지가 넘지만 금방 읽을 수 있어<sos>	이 책은 천 페이지가 넘지만 금방 읽을 수 있어
<sos>다이아몬드<sos>	다이아몬드
<sos>오리엔테이션<sos>	오리엔테이션
<sos>트럭<sos>	트렁크
<sos>나무도 오늘 방법이 있는 거야<sos>	남은 오이는 팩을 하려고 남겨둔 거야
<sos>평소 자세가 나쁜 사람은 디스크에요<sos>	평소 자세가 나쁜 사람은 디스크에 걸리기 쉬워요
<sos>마스크<sos>	마스크 한 장에 얼마예요
<sos>비싼 좌석에 바로 나이 비해서 너무 비싸더라<sos>	브이아이피 석은 다른 좌석에 비해서 너무 비싸더라
<sos>아시아<sos>	아시아
<sos>나 지금 외국어교육센터에서 근무하다<sos>	나 지금 외국어교육센터에서 근무하잖아
<sos>시진핑의 오존층<sos>	심판 실수로 노 골 선언되면 당연히 억울하지
<sos>난 나베만 먹으면 속이 별로야<sos>	난 나베만 먹으면 속이 별로야
<sos>오늘 방송에서 레 미제라블 하더라<sos>	오늘 방송에서 레 미제라블 하더라
<sos>오늘 방송에서 토이 스토리 하더라<sos>	오늘 방송에서 토이 스토리 하더라
<sos>일본에서 만들어진 스포츠 중에 가라테가 제일 유명해<sos>	일본에서 만들어진 스포츠 중에 가라테가 제일 유명해
<sos>디아블소 정말 붕괴테한 거 봐<sos>	궁금하면 포털사이트에 한 번 검색해봐
<sos>쥬라기<sos>	쥬라기 공원
<sos>하트<sos>	하트 셰이커
<sos>찰리<sos>	찰리 푸스
<sos>유치북<sos>	유튜브
<sos>해외에서 게리맨더링 사태로 난리가 났더라<sos>	해외에서 게리맨더링 사태로 난리가 났더라
<sos>야후<sos>	야후
<sos>이번에 길드원들 의견 받아서 길드명 다시 정한대<sos>	이번에 길드원들 의견 받아서 길드명 다시 정한대
<sos>프로그램<sos>	프로그램
<sos>비폭력 운동으로 가장 유명한 건 간디라고 생각해<sos>	비폭력 운동으로 가장 유명한 건 간디라고 생각해
<sos>포스코 공채 공고 떴어요<sos>	포스코 공채 공고 떴어요
<sos>스카이캐슬<sos>	스카이캐슬
<sos>테트리스만 하면 몇 시간은 금방 가요<sos>	테트리스만 하면 몇 시간은 금방 가요
<sos>어제 했던 런닝맨 어땠어요<sos>	어제 했던 런닝맨 어땠어요
<sos>지금 하는 게임 길드명이 좀 이상해<sos>	지금 하는 게임 길드명이 좀 이상해
<sos>은근 똠양꿍을 싫어하는 사람들 많아요<sos>	은근 똠양꿍을 싫어하는 사람들 많아요
<sos>양쪽이 똑같은 걸 보니 데칼코마니 기법인 것 같아<sos>	양쪽이 똑같은 걸 보니 데칼코마니 기법인 것 같아
<sos>탁구나 테니스는 듀스라는 특이한 규칙이 있어<sos>	탁구나 테니스는 듀스라는 특이한 규칙이 있어
<sos>카트보다 재밌는 게임이 있을까<sos>	카트보다 재밌는 게임이 있을까
<sos>질레트 면도기 가격이 얼마에요<sos>	질레트 면도기 가격이 얼마에요
<sos>데드 리프트가 언제 개봉했나<sos>	대체 길드명은 처음에 누가 정한 거야
<sos>요즘 방송에서 가오슝이 많이 나와서 가보고<sos>	요즘 방송에서 가오슝이 많이 나와서 가보고 싶어
<sos>너무 추워서 기모 바지 입었어<sos>	너무 추워서 기모 바지 입었어
<sos>나는 듀오로 게임을 돌려서 랭크를 쉽게 올렸어<sos>	나는 듀오로 게임을 돌려서 랭크를 쉽게 올렸어
<sos>여기는 아침에 햄버거를 안 파는구나<sos>	여기는 아침에 햄버거를 안 파는구나
<sos>미국에서 오바마 영향력이 아직 상당한가봐<sos>	미국에서 오바마 영향력이 아직 상당한가봐
<sos>나는 대학 졸업하고 더블유티오에서 일할 거야<sos>	나는 대학 졸업하고 더블유티오에서 일할 거야
<sos>요즘 마이크로소프트는 상황이 어때요<sos>	요즘 마이크로소프트는 상황이 어때요
<sos>리틀 포레스트<sos>	바게트에 크림을 많이 올려주시겠어요
<sos>노인들은 큐아르 코드 사용을 어려워한다<sos>	노인들은 큐아르 코드 사용을 어려워한다
<sos>메일<sos>	네임 밸류
<sos>가을 역시 낼 때 마다 빵꾸 달라<sos>	가루약보다 캡슐 약이 빠르게 흡수된다
<sos>우리 할아버지는 담배 한 개비를 꺼내 가스라이터로 불을 붙이셨다<sos>	우리 할아버지는 담배 한 개비를 꺼내 가스라이터로 불을 붙이셨다
<sos>골프<sos>	골프 스윙
<sos>이 치킨커틀릿은 꼭 소스에 찍어 먹어야 해<sos>	이 치킨커틀릿은 꼭 소스에 찍어 먹어야 해
<sos>어제 컨버전 작업 후 컴퓨터가 망가졌어<sos>	어제 컨버전 작업 후 컴퓨터가 망가졌어
<sos>부심은 그 볼이 골 라인 아웃되었다<sos>	부심은 그 볼이 골 라인 아웃되었다고 판정했다
<sos>케이스<sos>	케이스
<sos>승마경기에서 모든 게이트를 무사히 넘는 것이 중요하다<sos>	승마경기에서 모든 게이트를 무사히 넘는 것이 중요하다
<sos>저는 이 곡에서 베이스 드럼 소리가 제일 좋아요<sos>	저는 이 곡에서 베이스 드럼 소리가 제일 좋아요
<sos>미팅은 디렉스<sos>	위대한 유산은 찰스 디킨스의 작품이야
<sos>이 커플은 서로를 가장 아끼는 예쁜 커플이야<sos>	이 커플은 서로를 가장 아끼는 예쁜 커플이야
<sos>고글<sos>	고글
<sos>컬을 유지하기 위해서는 관리를 해야 합니다<sos>	컬을 유지하기 위해서는 관리를 해야 합니다
<sos>집에 올 때 크래커 두 박스만 사 올래<sos>	집에 올 때 크래커 두 박스만 사 올래
<sos>오늘 봤던 퀴즈는 내겐 너무 쉬워서 재미없었어<sos>	오늘 봤던 퀴즈는 내겐 너무 쉬워서 재미없었어
<sos>그는 배우지 커피는 분위기가 있는 편이야<sos>	그는 배우지 않아도 쿠킹센스가 있는 편이야
<sos>리더<sos>	리코더
<sos>여기 혹시 마크 시트 전용 연필 있나요<sos>	여기 혹시 마크 시트 전용 연필 있나요
<sos>그 사람은 카지노에 빠져서 힘들게 살았어<sos>	그 사람은 카지노에 빠져서 힘들게 살았어
<sos>컵 홀더는 필요 시 말씀해주시면 드리겠습니다<sos>	컵 홀더는 필요 시 말씀해주시면 드리겠습니다
<sos>어제 내가 먹었던 커피가 콩고커피였어<sos>	어제 내가 먹었던 커피가 콩고커피였어
