<sos>그리고 책상에 포스트잇<sos>	그리고 책상에 빼곡하게 붙어 있는 포스트잇들은 데이터로 만들어서 저장해
<sos>음 좀<sos>	음식 사진에서 생생한 근접샷은 필수거든
<sos>반려식물은 공기 정화 효과도 주지만 ,습기를 빨아들이는 효과도 있거든<sos>	반려식물은 공기 정화 효과도 주지만 ,습기를 빨아들이는 효과도 있거든
<sos>채지로<sos>	찬물을 묻혀서 식초나 중성 세제로 씻어주면 돼
<sos>그리고 잠<sos>	그리고 잠들기 두 시간 전부터는 금식이야
<sos>버<sos>	버린다고
<sos>그럼<sos>	그럼, 스프를 먼저 넣을게
<sos>뭐<sos>	왜 그럴까
<sos>그렇다고<sos>	그렇다고 부모님 용돈을 안 드릴 수도 없고 고민이에요
<sos>누가, 왜, 무엇을 나에게 물어볼 지 경우의 수줄 미리 적어놓는 거지<sos>	누가, 왜, 무엇을 나에게 물어볼 지 경우의 수를 미리 적어놓는 거지
<sos>어떻이죠<sos>	여보세요 어디시죠
<sos>당장 거실<sos>	당장 거실에 있는 쇼파도 가죽이고, 자동차의 시트도 가죽이잖아
<sos>썬크림<sos>	썬크림을 이용하면 가죽에 광택도 낼 수 있어
<sos>살 물<sos>	살 물건들은 적어 왔어
<sos>당연히<sos>	당연히 여러 개를 사면 할인해 주겠지
<sos>아침 시간엔 전날의 부부싸움, 출근길 교통 상황 때문에 부장의 심기가 상했는 경우가 많아<sos>	아침 시간엔 전날의 부부싸움, 출근길 교통 상황 때문에 부장의 심기가 상했는 경우가 많아
<sos>그러니까 아는 게 힘이라는 말이 생긴 거 아니냐<sos>	그러니까 아는 게 힘이라는 말이 생긴 거 아니냐
<sos>그럼, 꼬들한 면이 좋으면 스프 먼저, 푹 익은 라면이 좋으면 면을 먼저 넣으면 돼<sos>	그럼, 꼬들한 면이 좋으면 스프 먼저, 푹 익은 라면이 좋으면 면을 먼저 넣으면 돼
<sos>뭔<sos>	뭔데
<sos>그래서 아침밥은 일찍 출근하기로 했어요<sos>	그래서 아침밥은 포기하고 삼십 분 일찍 출근하기로 했어요
<sos>에이<sos>	에이 그런 게 어딨어
<sos>그런 부<sos>	그런 방법이 있어
<sos>혼자 하면<sos>	혼자 하기 어색하면 친구랑 같이 해도 좋겠다
<sos>난 요가하면<sos>	난 요가는 별루인데, 다른 건 없어
<sos>어우, 참<sos>	어우~ 요 며칠 날씨 참 좋다
<sos>그 다음<sos>	그 다음이 씨 캐롯이야
<sos>코로나도 그렇고 어르신들은 건강이 제일 걱정이잖아<sos>	코로나도 그렇고 어르신들은 건강이 제일 걱정이잖아
<sos>그 말엔<sos>	그 말엔 나도 완전 공감
<sos>날씨가<sos>	날씨가 쌀쌀해져서 그런가
<sos>하나 뜨면 엄만<sos>	하나 뜨면 줄줄줄 똑같은 것만 만들구
<sos>오~ 전문<sos>	오~ 전문가 같은데
<sos>그래도 와<sos>	그래도 오늘 날씨는 참 좋아 다행이다
