<sos>마으키소<sos>	마우스피
<sos>아니면 어떤 어떻게 몰<sos>	아니면 어떤 말을 해야
<sos>그러니까 오는 신십 가<sos>	그런데 어느 날부턴가 
<sos>태사에서 연부를 중에 <sos>	퇴사를 준비하는 모임
<sos>포로토핑 시경하면 하ㄴ<sos>	보통 식물은 햇빛이 
<sos>사물 걸무해 발문의 고<sos>	썬크림을 발라 놓고 
<sos>세무실 이속 나는 이제<sos>	주 오십이 시간 되고 근
<sos>잘 노르가 수어<sos>	장 보러 왔어
<sos>그걸 때는 거 얼마나 해<sos>	그거 떼느라 내가 얼마나 
<sos>방밌어 정번 거 하ㄹ<sos>	파일 정리하는 법이 
<sos>결혼 부분이 그 전ㅇ<sos>	갑자기 급가속을 하
<sos>카드 연행 사람 이르<sos>	가득이요 하는 게 폼 
<sos>그런 애들을 캐어나<sos>	그렇게 되기 전에 자
<sos>아, 김책으로 반이아<sos>	헌트그룹 커뮤니케이
<sos>매너를 배청도 긴처<sos>	맹물을 먹기 힘들
<sos>발력이랑 갈 게 아ㅇ<sos>	반려견도 영양제가 
<sos>주변에 하루버를 생<sos>	주기적으로 목욕을 
<sos>엄청 내가 알아ㅇ<sos>	와, 소문처럼 장
<sos>어처 커 버레이치 <sos>	어때 촉촉하고 맛
<sos>노래도 치업은 으<sos>	눈치 없는 후배 
<sos>그게 얼매이야<sos>	그게 왜 위험해
<sos>굉적해플 대스로<sos>	괜히 싫은 표정 
<sos>완제나 람 안된<sos>	원한다면 얼마
<sos>우리 대 무라도 데<sos>	오늘 물어봐도 될
<sos>건강함 집준해<sos>	걷는 거리에 따라
<sos>노두분가 친구도 사이에 이<sos>	미술관 기둥 사이에 여자 
<sos>생기조 하니 좋아<sos>	세상 많이 좋아졌
<sos>동상이라에서 해야 될 이ㄹ<sos>	식사 한 시간 전에 달걀
<sos>그건 어디지<sos>	그건 부장한
<sos>오늘 같넷<sos>	어떻게 그런
<sos>토양식은 모식이 뭐 보고<sos>	도시락을 싸게 되면 식당
<sos>그래서 꺼는 거야<sos>	그래서 옛날 거 함
<sos>실지리 타말 더 면 살지<sos>	시래기 삶을 때 쌀뜨물
<sos>놀려스트에 국전에 <sos>	녹두전에 굴젓을 곁
<sos>영화 엘 맛에<sos>	야 인생 헛살
<sos>주도엔서 선태가 듣<sos>	채소 같은 것도 사과
<sos>할 바되는<sos>	하하 재밌네
<sos>그런가<sos>	하하 그
<sos>그런 시한 지국이가<sos>	그런 취향이면 치앙
<sos>그렇게 중이가 늪으<sos>	그렇게 얘기해 주니까,
<sos>아, 그것도 있어<sos>	아, 그것도 유행
<sos>아직 가지고 왔나<sos>	아직 그 정도는 아
<sos>나도 내친구 내요일<sos>	어 내 친구는 아파트 
<sos>아 내려를 열성하서<sos>	아 집 안에서 제자리 
<sos>어니<sos>	아니
<sos>오늘 방숑 중을 꼬<sos>	온라인 주문 해 봤
<sos>그럼 사로<sos>	그럼, 사과
<sos>그러니까<sos>	그러니까
<sos>아, 좀 생각하자<sos>	아, 좋은 생각 났
<sos>그런 그렇대<sos>	그럼, 학용품
<sos>진행 수영서 많이 간 벼<sos>	진행 순서에 따라 작성
<sos>저 한 받으리네는 봐<sos>	정 안되면 바디랭귀
<sos>방연하기 판맨터 하면 <sos>	밤에 뛰면 직장인들도 
<sos>비가 비다의 만워 기습했<sos>	티비 틀어도 채널마다 비
<sos>얼마 점마 전씩 되게 되<sos>	얼마 전에도 카페에 갔는
<sos>지난번 방법동이 자국<sos>	지난번 동창 모임갔더
<sos>다른 건 시간 바로비지르<sos>	들어간 재료는 다 비슷
<sos>일 안 하나운데<sos>	이런 게 많이 나
<sos>가굴하는 걸 쪽을 ㅁ<sos>	가난한 친구를 배려
<sos>그건 또 나는데<sos>	그 비용은 또 얼
<sos>배일 이사하면 업치ㅇ<sos>	회사 일 해야지, 집안 
<sos>여기도 연예하면 여리<sos>	연애 얘기 하면 꼭 그
<sos>공견 그만 그걍 중ㅇ<sos>	공감만큼 중요한 게
<sos>내용 영양은 저 영ㅇ<sos>	내용은 이해가 잘 되
<sos>니가 나는 고양 많아<sos>	네가 경험이 많아서 
<sos>이런 버 봐<sos>	이것 좀 봐
<sos>그 말월 파시ㅇ<sos>	바로 비티에스 
<sos>그게 얼마나 그<sos>	그게 얼마가 라
<sos>한 아파니아 도<sos>	항아리 안에 동
<sos>근데 뭐가 지어<sos>	근데 지역 등
<sos>뭐 어떻게 결ㄱ<sos>	뭐 이런 것 하
<sos>건강도 다른 <sos>	거기도 막으면 
<sos>내가 이번에 이<sos>	내가 이번 여행
<sos>제계 조급하기 좀 있나<sos><sos>	자기 비하보다는 낫지 않
<sos>거 그것<sos>	어 그렇
<sos>우리 핀이 작간 하가<sos>	우리 대에서 끊기니까 
<sos>대우어서 케드는 인박하<sos>	대규모 수해는 계속 되풀
<sos>그래 그래 보내 보내 보내<sos>	그래 가지고 막 아미들이 
<sos>남의하면 이런 국을 샤<sos>	난 집에서 담는 거는 오
<sos>고라이에 이렇게 먹고 소<sos>	어떻게 내가 이 나이에 벌
<sos>맞아 그런 거 그런 거 그<sos>	그런거 그런 거 볼 때 좀
<sos>내가 배단사 한 번씩 반 별서 워<sos>	빠지더라고 그래서 내가 인젠 성인
<sos>물에 나라도 등백 승근하는 건 <sos>	우리 세대는 아무래도 매스컴이라
<sos>나무를 나무를 남아야하면<sos>	나물도 나물을 내가 좋아하
<sos>마이지 그런거 그 정말 좋아<sos>	정말 그런 그림책 굉장히 
<sos>그렇게 마서 전밥오를 틀어봤어<sos>	그렇다고 그거를 동네마트 가서 사
<sos>아, 가족이랑 가족이라서 같아요<sos><sos>	가족이랑 일 둘 다 신경쓰는게 
<sos>책구가 내는 연그러 생각으로 나<sos>	주말마다 하는 예능 방송 같은 
<sos>이런 게 먼제가 나는 또 나는 게 ㅂ<sos>	비오는 날은 부침개 먹는 날 이
<sos>나를 노유피 운동ㅎ<sos>	나를 눕히고 이제 허
<sos>보험색 하도 많이 <sos>	넣어도 맛이 없고 
<sos>별원에 효과가 물ㅇ<sos>	결론을 내 줄 필요
<sos>여기야 내가 느끔지<sos>	책을 딱 펴 놓고 
<sos>마통까지 시간 건 <sos>	어떨 땐 이십까지 
<sos>나무의 이거랑 나음<sos>	살리고 나쁜 사람
<sos>앞에는 영양시면<sos>	강에 대해서 좀신경
<sos>우리 책을 안 그런<sos>	우리 딸도 열 체질
<sos>그런 그렇게 보고 내가<sos>	근데 다 그러니까 좀 들
<sos>얼릴 영 수번에 올려<sos>	가스불에 올려갖고 하
<sos>그렇게 그렇게 하는 데<sos>	그래서 이제 그렇게 안 
<sos>지금 보르고 많이 도라<sos>	지금 보면은 많이 돌
<sos>뮤절도 있어서 별리사<sos>	유전적으로는 별 이상
<sos>수제로 우리 통 그런 거<sos>	실제로는 뭐 우리가 잘 
<sos>거기에 해보는 중간 조<sos>	한 육 개월 간 거기에 
<sos>하기도 김십은 점식ㅇ<sos>	확실히 병도 가족력이
<sos>건강이나 그런 그마<sos>	그리고 그만큼은 걸
<sos>이렇게 하다 볼다기<sos>	유럽 사람들이 우리
<sos>그거 연예전이라 다<sos>	그 다이어트도 건강
<sos>그렇게 현전에서 마<sos>	그럼 이렇게 잘라서 
<sos>그런데 시간 대한 ㅂ<sos>	근데 찹쌀을 네 시
<sos>그러니까 고금 되게 <sos>	그거는 뮤지컬은 되
<sos>시사페 떠문은 거 떠<sos>	주술사는 실사 편에
<sos>밀리 나 내 보가 버자<sos>	우리는 항상 거의 매
<sos>그 소선이 그런 좀 좀 <sos>	그 삼촌이 스카인데 거
<sos>내가 막 나오리 지겠어 <sos>	내가 너한테 얘기 했었
<sos>주스에는 어떻게 햄 할<sos>	진짜 옛날 말이 틀린 
<sos>무선 살에 내가 느끼러 <sos>	그라면서 자기는 옛날
<sos>어는 수 있는데 놓고 ㅇ<sos>	같이 운동하는 언니들
<sos>그런 이어디랑 같은 구<sos>	그러면 국내 가까운 지
<sos>이전 해 주세이언<sos>	얘기 좀 한 번 해
<sos>그런데 그런 중에 가먹<sos>	그런데 기생충도 나 두 
<sos>이따 요즘은 거 어떻<sos>	일단 중요한 거 그래
<sos>내가 전호는 걸 모느<sos>	내가 잡고 있으면 와 
<sos>저 체 톨 차도 앞지고<sos>	잘 치기는 뭘 잘 쳐 
<sos>지금 지금 지금 좀 <sos>	진짜 이거는 진짜 반
<sos>너무 기름값이 너무 <sos>	사 가지고 먹을 때마
<sos>근데 세 마이 모임이<sos>	근데 게임하면 그게 
<sos>펴머니가 우워서 살아<sos>	할머니 할아버지가 이
<sos>자장에 빨리 까주 공<sos>	아빠 차 타고 극장에 
<sos>먹는 어늘 아빠느<sos>	오늘 짝꿍이 아파
<sos>이건 좀 노 방송<sos>	이거 충전기 어디
<sos>아 냄배는 그거 내<sos>	그건 그럼 안 되
<sos>나는 그러던 색도<sos>	라떼가 새끼를 낳
<sos>줌 난 준체스면 <sos>	진짜 잘 난다 슈웅
<sos>기다른 필요한테<sos>	그러면 얼마나 더 
<sos>우리 온 만들지<sos>	엄마 나 물 좀 주
<sos>사 통케이캣으면<sos>	삼촌도 케이티엑
<sos>소엄청 이수니<sos>	샤워장이 어디 
<sos>엄마는 한줄<sos>	언젠가는 우주
<sos>엄마 나 같애<sos><sos>	엄마랑 같이 
<sos>코비에 또 밁으<sos>	거위를 키우게 
<sos>아니 거게 가는<sos>	알겠어 그럼 
<sos>우리 어리 어리<sos>	우리 언니는 영
<sos>기치 티자를 내<sos>	피자 피자는 내
<sos>주등학품 해ㄷ<sos>	드라큘라 이빨 
<sos>시기 번 나는 ㅇ<sos>	쓰레기 버리면 
<sos>여기 다 하나다<sos><sos>	여기다 하면 되
<sos>지근데 갈 가하<sos>	진짜 흔들흔
<sos>미국 초설 통ㅉ<sos>	미국 선생님이
<sos>내가 가도 돈 거<sos>	내 동생 피자 좋
<sos>타권 지곤 싸고<sos>	글씨 잘 쓴다고
<sos>이따 누가 더 놀<sos>	이거 엄마 갖다 
<sos>나는 다항소에<sos>	내 알림장이 없
<sos>매가 아프리고 있<sos>	내가 우리 집 강
<sos>우리 집은 꼭 이<sos>	우리 집은 물고
<sos>키 날랜드<sos>	비오는 날 
<sos>여기서 하나 게 사<sos>	여기 사람 있어요
<sos>계돌도리 잘 해 <sos>	개구리는 점프를
<sos>일으사 칼콜 아<sos>	니가 더 크니까 뒤
<sos>나는 현서 해야 <sos>	안녕 나는 서현
<sos>저기 병 모그를 <sos>	사과에 독을 묻
<sos>병은 구사하면<sos>	병원 가서 주사 
<sos>안직 보드 어 ㅂ<sos>	안 춥게 옷 입
<sos>운농에 아빠랑<sos>	놀래키면 안 돼
<sos>알에 시간 어르<sos>	싫어 이제 집에 
<sos>아빠 언노 투마<sos>	너 안 뚱뚱해
<sos>꼴랑밥아봐<sos>	호랑이 이빨 
<sos>아빠가 내가 어ㄸ<sos>	아기 염소가 늑
<sos>진짜 어디야 나<sos>	지나가는 어른
<sos>나는 이런 소리<sos>	너는 오른손이 
<sos>눈어니랑 아빠<sos>	금요일은 눈높
<sos>선버도 놀 받ㄱ<sos>	손바닥에 손톱
<sos>나는 다 진짜 ㄷ<sos>	나 때문에 지민
<sos>우리 두 좀 핸ㅈ<sos>	우리 지민이한
<sos>저기 읽오<sos>	저도 갖고 
<sos>칭층 너<sos>	진짜 나빠
<sos>이슈온 내일 시<sos>	아빠 이제 시원
<sos>우리 통에서 <sos>	우리가 오늘 
<sos>이거 나는 거<sos>	이거 엄마 거
<sos>사킬리나<sos>	세탁기에 
<sos>아빠랑 지금<sos>	아빠랑 같이 
<sos>이제 나쁘나 ㅎ<sos>	이제는 하나도
<sos>왜 그러니까 ㄱ<sos>	엄마 이거 봐 
<sos>할머니 자까 <sos>	할머니 이제 
<sos>나 먹을 뜯ㅇ<sos>	나 머리 자르
<sos>이제 섬첨 분 번 ㅎ<sos>	이제 선물을 준비
<sos>물마과 끊이랑 써ㅅ<sos>	엄청 떨렸는데 엄
<sos>내가 다 빠빠다 올라<sos>	내가 나무에 올라가 
<sos>응지 마마 내 미슬ㅎ<sos>	뭔지 모르겠어 달콤
<sos>미사에이<sos>	미사일
<sos>우리님 사과 내 배 ㅂ<sos>	어제 소개팅했던 사
<sos>매어띰<sos>	리모컨
<sos>자구 마니폴이 요몰<sos>	자료를 너무 많이 받
<sos>나는 결혼식 모츠<sos>	나는 최근에 스페
<sos>코믹<sos>	이코노
<sos>전 일<sos>	자장면
<sos>점리<sos>	자장
<sos>그래서 제사골을 ㅎ<sos>	그래서 재미있는 쇼
<sos>내가 워크리에서 커<sos>	내 커피에는 우유와 
<sos>소셜된 어떻게 하<sos>	소셜 네트워크 서비
<sos>그러네 호시포스팅<sos>	그래서 재미있는 쇼
<sos>바톤바<sos>	카운터
<sos>마시란들의 ㅎ<sos>	난 하루에 한 
<sos>오늘에 아무로<sos>	오늘 여섯 시
<sos>오늘은 가이ㄹ<sos>	오늘은 가로무
<sos>발러<sos>	달러
<sos>메딸<sos>	메달
<sos>셰증<sos>	재즈
<sos>이 카페는 이ㅂ<sos>	이 카페는 발
<sos>사럼<sos>	사우나
<sos>수팔<sos>	스팸
<sos>포켓로그은 따로<sos>	폭탄 테러로 이곳
<sos>내러서 라면 도라<sos>	이런 옷은 드라이
<sos>루세일 다이어트ㅇ<sos>	요새는 다이어트보
<sos>그런 세 계쁜 색<sos>	붉은색보다는 
<sos>오늘 동화의 대이<sos>	모바일 데이터를 
<sos>내 생각에서 내가<sos>	내 생각에는 알
<sos>요즘 폰으로치ㄹ<sos>	유능한 코치는 
<sos>응 치노가 칼릿<sos>	우린 신혼부부 
<sos>우리 폰에 점 자<sos>	오늘 진짜 추우
<sos>누 토서프는 육<sos>	무서우니까 그 터
<sos>선풍를 처는 ㅍ<sos>	산을 뚫어야 해
<sos>그냥 나으래도 ㄷ<sos>	그 영화에 레오나
<sos>배일로<sos>	페이스
<sos>슈가 방에 미스ㄹ<sos>	최근에 판빙빙
<sos>세계속 내가<sos>	세계에 네스카
<sos>돌핑하는 ㄱ<sos>	동남아에서 
<sos>슈프<sos>	시그
<sos>이 코가 이상<sos>	이상과 현실
<sos>선새 한 이ㄹ<sos>	선을 이용해
<sos>좋은 킹 러<sos>	친구는 돈키
<sos>영화 동스트<sos>	너 어제 나온 
<sos>엄청 나이트<sos>	어제 했던 미
<sos>이게뉴<sos>	힐러리
<sos>짐 선수는 이<sos>	제일 재미있게
<sos>그런지<sos>	프렌즈
<sos>나는 새책ㅏㄱ하<sos>	난 색채가 강
<sos>브랑쓰<sos>	프랑스
<sos>키드<sos>	휴대
<sos>난 내 대백하<sos>	나는 레드벨벳
<sos>네 치칸프를 <sos>	네스카페에 취
<sos>난 티브에서 나이<sos>	난 게임 포인트
<sos>요즘에 치우하면<sos>	유명한 유럽의 
<sos>에오바에요<sos>	에어프라이
<sos>아이웨<sos>	아이유
<sos>소워벨 가는 사ㄹ<sos>	수학을 전공하
<sos>듀<sos>	듀
<sos>지병 사어서 살ㄷ<sos>	집에 올 때 메로
<sos>최근에 브랙 프ㄹ<sos>	최근에 브래드 피
<sos>최근에 나온 ㅊ<sos>	최근에 나온 아
<sos>인태한 좋가ㅇ<sos>	인텔 현재 주
<sos>배드<sos>	배드 
<sos>미스토피스 전<sos>	요즘 위 스포츠 
<sos>배일 네이티 저<sos>	바이든의 정치 
<sos>나는 두름 고ㄹ<sos>	나는 도르트문
<sos>아, 그리게 대드<sos>	한국 사람들
<sos>그렇게 봩연ㅇ<sos>	그렇게 매주 네
<sos>으<sos>	록
<sos>크아크 다 호래 가<sos>	퇴근 전에 상사에
<sos>미국 터니로 통해<sos>	미국 주유소는 단
<sos>나는 보섯 그런 <sos>	나는 보석 중에서
<sos>그라즈<sos>	글라스
<sos>코<sos>	껌
<sos>큰틸돌<sos>	컨트리 
<sos>우리 공제를 자구<sos>	곤색 잠바를 입
